{
  "width": 5,
  "height": 5,
  "bg_data": [
    [".", ".", ".", ".", "."],
    [".", "~", "~", "~", "."],
    [".", "~", "~", "~", "."],
    [".", "~", "~", "~", "."],
    [".", ".", ".", ".", "."]
  ],
  "fg_data": [
    [" ", " ", " ", " ", " "],
    [" ", " ", " ", " ", " "],
    [" ", " ", " ", " ", " "],
    [" ", " ", " ", " ", " "],
    [" ", " ", " ", " ", " "]
  ]
}
