{
  "width": 6,
  "height": 5,
  "bg_data": [
    ["#", "#", "#", "#", "#", "#"],
    ["#", ".", ".", ".", ".", "#"],
    ["#", ".", ".", ".", ".", "#"],
    ["#", ".", ".", ".", ".", "#"],
    ["#", "#", "+", "#", "#", "#"]
  ],
  "fg_data": [
    [" ", " ", " ", " ", " ", " "],
    [" ", " ", " ", " ", " ", " "],
    [" ", " ", " ", " ", " ", " "],
    [" ", " ", " ", " ", " ", " "],
    [" ", " ", " ", " ", " ", " "]
  ]
}
